Accent/ñ fixes applied: 279 mappings

Mappings applied:
- acompaan -> acompañan
- actan -> actúan
- adems -> además
- advirti -> advirtió
- algn -> ALGN
- anatoma -> anatomía
- anestsica -> anestésica
- antibiticos -> antibióticos
- aplicacin -> aplicación
- araa -> araña
- Area -> Área
- Areas -> Áreas
- armnicas -> armónicas
- asimetra -> asimetría
- autorizacin -> autorización
- bceps -> bíceps
- Bceps -> Bíceps
- brasilea -> brasileña
- Brasileo -> Brasileño
- cafena -> cafeína
- ccteles -> cócteles
- cicatrizacin -> cicatrización
- cidos -> ácidos
- circulacin -> circulación
- Ciruga -> Cirugía
- cirugas -> cirugías
- clavculas -> clavículas
- Claviculas -> Clavículas
- clido -> cálido
- clnica -> clínica
- clnicas -> clínicas
- clnicos -> clínicos
- clsico -> clásico
- cmoda -> cómoda
- cmodo -> cómodo
- cmodos -> cómodos
- cnula -> cánula
- cojin -> cojín
- cojn -> cojín
- colageno -> colágeno
- colgeno -> colágeno
- comezn -> comezón
- comnmente -> comúnmente
- compresin -> compresión
- condicin -> condición
- contctenos -> contáctenos
- Contctenos -> Contáctenos
- contina -> continúa
- continan -> continúan
- convirtindolo -> convirtiéndolo
- Correccin -> Corrección
- cortesa -> cortesía
- cosmtica -> cosmética
- cosmtico -> cosmético
- crdito -> crédito
- credito -> crédito
- crnico -> cárnico
- Cuntas -> Cuántas
- Cunto -> Cuánto
- Cuntos -> Cuántos
- cutnea -> cutánea
- cutneas -> cutáneas
- cutneo -> cutáneo
- Cutneo -> Cutáneo
- daada -> dañada
- daar -> dañar
- definicin -> definición
- Definicin -> Definición
- depilacin -> depilación
- Depilacin -> Depilación
- depsitos -> depósitos
- desarrollndose -> desarrollándose
- descamacin -> descamación
- desintoxicacin -> desintoxicación
- despus -> después
- Despus -> Después
- dinmicas -> dinámicas
- diseado -> diseñado
- Diseado -> Diseñado
- diseados -> diseñados
- disear -> diseñar
- drmica -> dérmica
- drmicas -> dérmicas
- drmico -> dérmico
- drmicos -> dérmicos
- duracin -> duración
- Edicion -> Edición
- electromagnticos -> electromagnéticos
- eliminacin -> eliminación
- Eliminacin -> Eliminación
- Encas -> Encasé
- energa -> energía
- Enzimtica -> Enzimática
- Epidrmica -> Epidérmica
- escisin -> escisión
- espculas -> espículas
- especficamente -> específicamente
- especficas -> específicas
- especficos -> específicos
- estacin -> estación
- estimulacin -> estimulación
- estn -> están
- estndar -> estándar
- Estndar -> Estándar
- Estras -> Estrías
- estratgicamente -> estratégicamente
- estriles -> estériles
- estrs -> estrés
- esttica -> estática
- evaluacin -> evaluación
- expresin -> expresión
- extraccin -> extracción
- flcida -> flácida
- flcidas -> flácidas
- folculos -> folículos
- formacin -> formación
- fotografa -> fotógrafa
- fras -> frías
- friccin -> fricción
- frmula -> fórmula
- fsica -> física
- Fusion -> Fusión
- generacin -> generación
- genrica -> genérica
- Genrico -> Genérico
- glteos -> glúteos
- Glteos -> Glúteos
- Gluteos -> Glúteos
- hbitos -> hábitos
- hbrido -> híbrido
- hidratacin -> hidratación
- Hidratacin -> Hidratación
- hinchazn -> hinchazón
- holstica -> holística
- Iluminacin -> Iluminación
- indicacin -> indicación
- infeccin -> infección
- inflamacin -> inflamación
- Inflamacin -> Inflamación
- infusin -> infusión
- inmunolgicos -> inmunológicos
- instantneo -> instantáneo
- interrupcin -> interrupción
- intervencin -> intervención
- Inyeccin -> Inyección
- irritacin -> irritación
- jabn -> jabón
- Juvderm -> Juvéderm
- Laser -> Láser
- Lctico -> Láctico
- learn -> leñarán
- lesin -> lesión
- linftica -> linfática
- linftico -> linfático
- lminas -> láminas
- lnea -> línea
- Lnea -> Línea
- lneas -> líneas
- Lneas -> Líneas
- lser -> láser
- magnticos -> magnéticos
- Mandbula -> Mandíbula
- manipulacin -> manipulación
- Mantngase -> Manténgase
- mavemedicalspa -> MaveMedicalSpa
- mayora -> mayoría
- mdica -> médica
- mdicas -> médicas
- mdico -> médico
- mdicos -> médicos
- Mdicos -> Médicos
- mentn -> mentón
- Mentn -> Mentón
- metlico -> metálico
- microneedling -> Microneedling
- migracin -> migración
- mltiples -> múltiples
- mnima -> mínima
- mnimamente -> mínimamente
- mnimo -> mínimo
- Mnimo -> Mínimo
- mscara -> máscara
- msculos -> músculos
- mtodo -> método
- mtodos -> métodos
- mximo -> máximo
- ndulos -> nódulos
- nico -> único
- nmero -> número
- Nutricin -> Nutrición
- opcin -> opción
- oxgeno -> oxígeno
- penetracin -> penetración
- pequea -> pequeña
- Pequea -> Pequeña
- pequeas -> pequeñas
- Pequena -> Pequeña
- pequeo -> pequeño
- pequeos -> pequeños
- personalizacin -> personalización
- peticin -> petición
- picazn -> picazón
- pigmentacin -> pigmentación
- pmulos -> pómulos
- pptidos -> péptidos
- prcticamente -> prácticamente
- prdida -> pérdida
- precisin -> precisión
- preparacin -> preparación
- presin -> presión
- Presin -> Presión
- prevencin -> prevención
- produccin -> producción
- propagacin -> propagación
- Prpados -> Párpados
- ptima -> óptima
- ptimos -> óptimos
- quirrgica -> quirúrgica
- Quirrgico -> Quirúrgico
- qumico -> químico
- recin -> recién
- recomendacin -> recomendación
- recuperacin -> recuperación
- reduccin -> reducción
- Reduccin -> Reducción
- regeneracin -> regeneración
- Regeneracin -> Regeneración
- regin -> región
- Regin -> Región
- relajacin -> relajación
- remodelacin -> remodelación
- Remodelacin -> Remodelación
- renovacin -> renovación
- Renovacin -> Renovación
- renovacion -> renovación
- Renovacion -> Renovación
- reparacin -> reparación
- Reparacin -> Reparación
- restauracin -> restauración
- revitalizacin -> revitalización
- roscea -> rosácea
- rpida -> rápida
- rpido -> rápido
- salmn -> salmón
- sangunea -> sanguínea
- sanguneo -> sanguíneo
- sculptra -> Sculptra
- seales -> señales
- segn -> según
- sensacin -> sensación
- sesin -> sesión
- sintomtico -> sintomático
- slida -> sólida
- solucin -> solución
- sostn -> sostén
- subcutneos -> subcutáneos
- succin -> succión
- supervisin -> supervisión
- sylfirm -> Sylfirm
- tamano -> tamaño
- tamao -> tamaño
- Tambin -> También
- tcnica -> técnica
- tcnicas -> técnicas
- tecnologa -> tecnología
- Tendr -> Tendrá
- tensin -> tensión
- teraputica -> terapéutica
- teraputico -> terapéutico
- tirn -> tirón
- tpica -> típica
- tpicamente -> típicamente
- tpicos -> típicos
- traccin -> tracción
- travs -> través
- trceps -> tríceps
- Trceps -> Tríceps
- ubicacin -> ubicación
- ungento -> ungüento

Files updated:
- lib/data/normalized/translations/body-medical-treatments.json
- lib/data/normalized/translations/collagen-biostimulators.json
- lib/data/normalized/translations/dermal-fillers.json
- lib/data/normalized/translations/facials.json
- lib/data/normalized/translations/laser-resurfacing.json
- lib/data/normalized/translations/microneedling-mesotherapy.json
- lib/data/normalized/translations/podiatry.json
- lib/data/normalized/translations/skin-tightening.json
- lib/data/normalized/translations/wrinkle-reducers.json
- public/locales/es/home.json
- public/locales/es/layout.json
- public/locales/es/learn.json
- public/locales/es/legal.json
- public/locales/es/team.json
- public/locales/es/thankyou.json
- public/locales/es/treatments.json